1111111111
0000100000
0000100000
0000100000
0000100000
0000110000
0000000000
0000000001
0000000000
0000000000
0000000000